"filename", "language", "JSON", "JavaScript", "TypeScript", "comment", "blank", "total"
"d:\src\github-ramesh\POCs\webrtc-poc\webrtc-react-native-poc\components\call-window\call-window-audio.js", "JavaScript", 0, 74, 0, 2, 11, 87
"d:\src\github-ramesh\POCs\webrtc-poc\webrtc-react-native-poc\components\call-window\call-window-video.js", "JavaScript", 0, 283, 0, 73, 75, 431
"d:\src\github-ramesh\POCs\webrtc-poc\webrtc-react-native-poc\components\call-window\call-window.js", "JavaScript", 0, 82, 0, 20, 23, 125
"d:\src\github-ramesh\POCs\webrtc-poc\webrtc-react-native-poc\components\call-window\index.js", "JavaScript", 0, 2, 0, 0, 2, 4
"d:\src\github-ramesh\POCs\webrtc-poc\webrtc-react-native-poc\components\call-window\members.json", "JSON", 32, 0, 0, 0, 0, 32
"d:\src\github-ramesh\POCs\webrtc-poc\webrtc-react-native-poc\components\call-window\temp.json", "JSON", 68, 0, 0, 0, 0, 68
"d:\src\github-ramesh\POCs\webrtc-poc\webrtc-react-native-poc\libs\webrtc\WebRTCAudioStreaming.ts", "TypeScript", 0, 0, -24, -2, -8, -34
"d:\src\github-ramesh\POCs\webrtc-poc\webrtc-react-native-poc\libs\webrtc\WebRTCHandler.ts", "TypeScript", 0, 0, -770, -64, -209, -1043
"d:\src\github-ramesh\POCs\webrtc-poc\webrtc-react-native-poc\libs\webrtc\WebRTCSendAudioMessage.ts", "TypeScript", 0, 0, -67, -2, -21, -90
"d:\src\github-ramesh\POCs\webrtc-poc\webrtc-react-native-poc\libs\webrtc\WebRTCSendSystemCommandMessage.ts", "TypeScript", 0, 0, -24, -2, -9, -35
"d:\src\github-ramesh\POCs\webrtc-poc\webrtc-react-native-poc\libs\webrtc\WebRTCSendTextMessage.ts", "TypeScript", 0, 0, -26, -2, -11, -39
"d:\src\github-ramesh\POCs\webrtc-poc\webrtc-react-native-poc\libs\webrtc\WebRTCSendVideoMessage.ts", "TypeScript", 0, 0, -61, -3, -19, -83
"d:\src\github-ramesh\POCs\webrtc-poc\webrtc-react-native-poc\libs\webrtc\WebRTCVideoStreaming.ts", "TypeScript", 0, 0, -25, -2, -9, -36
"d:\src\github-ramesh\POCs\webrtc-poc\webrtc-react-native-poc\libs\webrtc\core\WebRTCCallService.ts", "TypeScript", 0, 0, -819, -72, -242, -1133
"d:\src\github-ramesh\POCs\webrtc-poc\webrtc-react-native-poc\libs\webrtc\core\WebRTCCallServiceFacade.ts", "TypeScript", 0, 0, -275, -27, -86, -388
"d:\src\github-ramesh\POCs\webrtc-poc\webrtc-react-native-poc\libs\webrtc\core\WebRTCChannelsCollection.ts", "TypeScript", 0, 0, -133, -20, -42, -195
"d:\src\github-ramesh\POCs\webrtc-poc\webrtc-react-native-poc\libs\webrtc\models\Channel.ts", "TypeScript", 0, 0, -11, -1, -1, -13
"d:\src\github-ramesh\POCs\webrtc-poc\webrtc-react-native-poc\libs\webrtc\models\ChannelMessage.ts", "TypeScript", 0, 0, -26, -2, -2, -30
"d:\src\github-ramesh\POCs\webrtc-poc\webrtc-react-native-poc\libs\webrtc\models\ChannelMessages.ts", "TypeScript", 0, 0, -5, -1, -2, -8
"d:\src\github-ramesh\POCs\webrtc-poc\webrtc-react-native-poc\libs\webrtc\models\DataChannelLabel.ts", "TypeScript", 0, 0, -86, -13, -23, -122
"d:\src\github-ramesh\POCs\webrtc-poc\webrtc-react-native-poc\libs\webrtc\models\SignalingMessage.ts", "TypeScript", 0, 0, -8, -1, -3, -12
"d:\src\github-ramesh\POCs\webrtc-poc\webrtc-react-native-poc\libs\webrtc\models\SystemCommand.ts", "TypeScript", 0, 0, -40, -6, -17, -63
"d:\src\github-ramesh\POCs\webrtc-poc\webrtc-react-native-poc\libs\webrtc\utils\colabLog.ts", "TypeScript", 0, 0, -12, -1, -3, -16
"d:\src\github-ramesh\POCs\webrtc-poc\webrtc-react-native-poc\libs\webrtc\utils\turnServerList.ts", "TypeScript", 0, 0, -31, 0, -8, -39
"Total", "-", 100, 441, -2443, -126, -604, -2632